%%%%%%%%%%%%%%%%%%
%P .ooooooooooo  %
%o%%%%%%%%%%%%o% %
%o%%%%%%%%%%%%o% %
%o%%%%%%%%%%%%o% %
%o%%%%%%%%%%%%o% %
%oooooooooooooo  %
%%%%%%%%%%%%%%%%%%
